1111111
1000101
101P001
1111111