1111111111
1C01000001
1001001001
1P000EC001
1111111111