1111111111
1EC01010C1
100010P001
101000C001
1111111111