1111111111
1010100001
10010010P1
1EC0000001
1111111111