1111111111
1C10100001
10010010P1
1E0000C001
1111111111