111111111111
10000C01C0C1
1CPC00000E01
10C00000C001
100000000001
111111111111